[
	{
    "name": "GROUP_BUS_STATION",
    "type": "monstergroup",
    "monsters": [
		{ "monster": "mon_zombie", "weight": 1, "cost_multiplier": 7, "pack_size": [ 5, 20 ] },
		{ "monster": "mon_zombie", "weight": 1, "cost_multiplier": 13, "pack_size": [ 15, 40 ] },
		{ "monster": "mon_zombie", "weight": 1, "cost_multiplier": 20, "pack_size": [ 25, 60 ] },
		{ "monster": "mon_zombie", "weight": 472, "cost_multiplier": 0 },
		{ "monster": "mon_zombie_fat", "weight": 75, "cost_multiplier": 2 },
		{ "monster": "mon_zombie_fat", "weight": 3, "cost_multiplier": 7, "pack_size": [ 3, 5 ] },
		{ "monster": "mon_zombie_tough", "weight": 75, "cost_multiplier": 3 },
		{ "monster": "mon_zombie_child", "weight": 75 },
		{ "monster": "mon_zombie_rot", "weight": 50, "cost_multiplier": 3 },
		{ "monster": "mon_zombie_crawler", "weight": 25, "cost_multiplier": 3 },
		{ "monster": "mon_zombie_dog", "weight": 20, "cost_multiplier": 2 },
		{ "monster": "mon_zombie_dog", "weight": 1, "cost_multiplier": 4, "pack_size": [ 3, 5 ] },
		{ "monster": "mon_zombie_dog", "weight": 1, "cost_multiplier": 16, "pack_size": [ 5, 8 ] },
		{ "monster": "mon_zombie_dog", "weight": 1, "cost_multiplier": 24, "pack_size": [ 8, 12 ] },
		{ "monster": "mon_dog_zombie_cop", "weight": 5, "cost_multiplier": 4 },
		{ "monster": "mon_dog_zombie_rot", "weight": 5, "cost_multiplier": 5 },
		{ "monster": "mon_zombie_soldier", "weight": 10, "cost_multiplier": 2 },
		{ "monster": "mon_zombie_cop", "weight": 20, "cost_multiplier": 3 },
		{ "monster": "mon_zombie_swat", "weight": 10, "cost_multiplier": 3 },
		{ "monster": "mon_zombie_medical", "weight": 10, "cost_multiplier": 2 },
		{ "monster": "mon_zombie_hazmat", "weight": 10, "cost_multiplier": 3 },
		{ "monster": "mon_zombie_fireman", "weight": 10, "cost_multiplier": 2 },
		{ "monster": "mon_zombie_swimmer", "weight": 10, "cost_multiplier": 5 },
		{ "monster": "mon_zombie_static", "weight": 10, "cost_multiplier": 5 },
		{ "monster": "mon_zombie_survivor", "weight": 1, "cost_multiplier": 25, "starts": "30 days" },
		{ "monster": "mon_zombie_survivor_elite", "weight": 1, "cost_multiplier": 25, "starts": "60 days" },
		{ "monster": "mon_beekeeper", "weight": 1, "cost_multiplier": 5 },
		{ "monster": "mon_zombie_technician", "weight": 1, "cost_multiplier": 12 },
		{ "monster": "mon_zombie_runner", "weight": 20, "cost_multiplier": 5, "pack_size": [ 1, 4 ] },
		{ "monster": "mon_feral_human_pipe", "weight": 4, "pack_size": [ 2, 3 ] },
		{ "monster": "mon_feral_human_crowbar", "weight": 4, "pack_size": [ 2, 3 ] },
		{ "monster": "mon_feral_human_axe", "weight": 2, "cost_multiplier": 2, "pack_size": [ 1, 2 ] },
		{ "monster": "mon_feral_sapien_spear", "weight": 1, "cost_multiplier": 2 },
		{ "monster": "mon_feral_soldier", "weight": 1, "cost_multiplier": 5 },
		{ "monster": "mon_zombie_brainless", "weight": 65 },
		{ "group": "GROUP_MIB", "weight": 100, "repeat": [ 2, 3 ], "starts": "2 days" },
		{ "group": "GROUP_MIB", "weight": 200, "repeat": [ 2, 3 ], "starts": "20 days" }
    ]
	},
  {
    "type": "mapgen",
    "method": "json",
    "om_terrain": [ [ "bus_stat_0", "bus_stat_1" ] ],
    "weight": 250,
    "object": {
      "fill_ter": "t_floor",
      "rows": [
        "...........''________'ssssssssPyyyyyyyyyyy___sss",
        "....,,,....''________',;,,;,,,;yyyyyyyyyyy___s,s",
        "||||www||||ss________'sssssssss______________s;s",
        "|p       p|ss________________________________s,s",
        "| BBB BBB |ss________________________________s,s",
        "|         wss________________________________s,s",
        "| BBB BBB wss______________________yy________s;s",
        "|         wss______________________yy________s,s",
        "| BBB BBB |ss______________________yy________s,s",
        "|         |Gs______________________yy________s;s",
        "| BBB BBB |Gs______________________yy________P,s",
        "|         +ss________''''''''''______________s,s",
        "|8        +ss________'I'bbbb'I'______________s;s",
        "|9  r    Y|ss________________________________s,s",
        "||+|||ddd||ss________________________________s,s",
        "|S:S|x h r|ss________________________________s;s",
        "|:::|ddd cwss______________________yy________s,s",
        "|+|+|||| cwss______________________yy________s,s",
        "|:|:|FF| cwss______________________yy________s,s",
        "|T|T|l:|  |ss______________________yy________s;s",
        "|||||i:+  +ss______________________yy________P,s",
        "...4|||||||ssssssssss''''''''''sssssssssssssssss",
        "..........fssssssssss'I'bbbb'I'sssssssssssssssss",
        "..........ffffffffffffffffffffffffffffffffffffff"
      ],
      "terrain": {
        " ": "t_floor",
        "+": "t_door_c",
        ".": "t_region_groundcover_urban",
        ",": [
          [ "t_region_groundcover", 35 ],
          [ "t_region_groundcover_forest", 20 ],
          [ "t_region_shrub_decorative", 20 ],
          [ "t_region_shrub_fruit", 10 ]
        ],
        ";": "t_region_shrub_decorative",
        "w": "t_window",
        "_": "t_pavement",
        "y": "t_pavement_y",
        "s": "t_concrete",
        "G": "t_concrete",
        "'": "t_thconc_floor",
        "b": "t_thconc_floor",
        "4": "t_gutter_downspout",
        "|": "t_wall",
        "S": "t_linoleum_white",
        ":": "t_linoleum_white",
        "T": "t_linoleum_white",
        "F": "t_linoleum_white",
        "l": "t_linoleum_white",
        "x": "t_linoleum_white",
        "i": "t_ladder_up",
        "I": "t_column",
        "P": "t_concrete",
        "f": "t_chainfence"
      },
      "furniture": {
        "x": "f_console_broken",
        "c": "f_counter",
        "S": "f_sink",
        "B": "f_bench",
        "b": "f_bench",
        "l": "f_locker",
        "d": "f_desk",
        "r": "f_trashcan",
        "p": [ "f_indoor_plant", "f_indoor_plant_y" ],
        "h": "f_chair",
        "Y": "f_rack_coat",
        "F": "f_filing_cabinet",
        "P": "f_traffic_light",
        "G": "f_bulletin"
      },
      "items": {
        "d": { "item": "office", "chance": 45, "repeat": [ 1, 2 ] },
        "Y": { "item": "jackets", "chance": 55, "repeat": [ 1, 6 ] },
        "l": { "item": "cleaning", "chance": 75, "repeat": [ 1, 3 ] },
        "r": { "item": "trash", "chance": 60, "repeat": [ 1, 2 ] },
        "B": [ { "item": "novels", "chance": 10 }, { "item": "jackets", "chance": 5 } ],
        "F": { "item": "file_room", "chance": 70, "repeat": [ 1, 3 ] }
      },
      "place_monsters": [ { "monster": "GROUP_BUS_STATION", "x": [ 3, 17 ], "y": [ 13, 15 ] } ],
      "place_vehicles": [
        { "vehicle": "buses", "x": 35, "y": [ 6, 7 ], "chance": 35, "status": 0, "rotation": 360 },
        { "vehicle": "buses", "x": 35, "y": [ 16, 17 ], "chance": 35, "status": 0, "rotation": 360 }
      ],
      "vendingmachines": { "8": { "item_group": "vending_drink", "lootable": true }, "9": { "item_group": "vending_food", "lootable": true } },
      "toilets": { "T": {  } }
    }
  },
  {
    "type": "mapgen",
    "method": "json",
    "om_terrain": [ [ "bus_stat_0_roof", "bus_stat_1_roof" ] ],
    "weight": 100,
    "object": {
      "fill_ter": "t_flat_roof",
      "rows": [
        "................................................",
        "................................................",
        "-----------.....................................",
        "|         3.....................................",
        "|         3.....................................",
        "|  ooooo  3.....................................",
        "|  ooooo  3.....................................",
        "|         3.....................................",
        "| A     & 3.....................................",
        "|         3.....................................",
        "|         3.....................................",
        "|  ooooo  3..........                ...........",
        "|  ooooo  3..........                ...........",
        "|         3.....................................",
        "|         3.....................................",
        "|         3.....................................",
        "| A   X : 3.....................................",
        "|         3.....................................",
        "|         3.....................................",
        "|         3.....................................",
        "22222!    3.....................................",
        "....5222222..........                ...........",
        ".....................                ...........",
        "................................................"
      ],
      "terrain": {
        " ": "t_flat_roof",
        ".": "t_open_air",
        "-": "t_gutter_west",
        "|": "t_gutter_west",
        "3": "t_gutter_east",
        "2": "t_gutter_south",
        "5": "t_gutter_drop",
        "!": "t_ladder_down",
        "o": "t_glass_roof"
      },
      "furniture": { ":": "f_cellphone_booster", "X": "f_small_satelitte_dish", "&": "f_roof_turbine_vent", "A": "f_air_conditioner" }
    }
  }
]
