[
	{
    "type": "mapgen",
    "method": "json",
    "om_terrain": [ 
		[ "ufo_medium00", "ufo_medium10" ], 
		[ "ufo_medium01", "ufo_medium11" ] 
	],
    "weight": 100,
    "object": {
		"predecessor_mapgen": "field",
		"fill_ter": "t_region_soil",
		"rows": [
			"                                                ",
			"                                                ",
			"                                                ",
			"                                                ",
			"                                                ",
			"                                                ",
			"                                                ",
			"                                                ",
			"                                                ",
			"                                                ",
			"                                                ",
			"                                                ",
			"                                                ",
			"                                                ",
			"                                                ",
			"                                                ",
			"                                                ",
			"                                                ",
			"                                                ",
			"                                                ",
			"                                                ",
			"                                                ",
			"      XXXXXXXXXXXX                              ",
			"     XXXXXXXXXXXXXXXXXXXXXXXXX                  ",
			"     XXXXXXXXXXXXXXXXXXXXXXXXXXXXXXXXXXXXXX     ",
			"    XXXXXXXXXXXXXXXXXXXXXXXXXXXXXXXXXXXXXXX     ",
			"    XXXXXXXXXXXXXXXXXXXXXXXXXXXXXXXXXXXXXXXX    ",
			"    XXXXXXXXXXXXXXXXXXXXXXXXXXXXXXXXXXXXXXXX    ",
			"    DDDDDDDDDDDDDDDDDDDDDDDDDDDDDDDDDDDDDDDD    ",
			"                  DDDDDDDDDDDDDDDDDDDDDDDDD     ",
			"                              DDDDDDDDDDDDD     ",
			"                                                ",
			"                                                ",
			"                                                ",
			"                                                ",
			"                                                ",
			"                                                ",
			"                                                ",
			"                                                ",
			"                                                ",
			"                                                ",
			"                                                ",
			"                                                ",
			"                                                ",
			"                                                ",
			"                                                ",
			"                                                ",
			"                                                "
		],
    "terrain": {
        "D": "t_concrete",
        "X": "t_concrete",
        "Y": "t_concrete",
        "W": "t_concrete",
        "Z": "t_concrete"
    },
	"//": "Whatever the top line is, it should have the RAMP_UP flag",
    "furniture": {
        "*": "f_region_flower_decorative",
        "Y": "f_rack_coat",
        "&": "f_trashcan",
        "$": "f_hedge_short",
        "^": [ [ "f_grave_head", 3 ], [ "f_grave_stone", 5 ], "f_grave_stone_old", "f_statue" ],
        "M": "f_grave_monument",
        "x": "f_grave_stone_old",
        "P": "f_sign",
        "S": "f_statue",
        "b": "f_bench",
        "n": "f_slab"
    },
    "items": {
        "A": { "item": "grave_memories", "chance": 1 }
    }
    }
	},
	{
    "type": "mapgen",
    "method": "json",
    "om_terrain": [ 
		[ "ufo_medium00_roof", "ufo_medium10_roof" ], 
		[ "ufo_medium01_roof", "ufo_medium11_roof" ] 
	],
    "weight": 100,
    "object": {
		"rows": [
			"                                                ",
			"                                                ",
			"                                                ",
			"                                                ",
			"                                                ",
			"                                                ",
			"                                                ",
			"                                                ",
			"                                                ",
			"                                                ",
			"                                                ",
			"                                                ",
			"                                                ",
			"                                                ",
			"                ZZZZZZZZZZZZZ                   ",
			"              ZZZZZZZZZZZZZZZZZZ                ",
			"            WWWWWWWWWWWWWWWWWWWWWWW             ",
			"          WWWWWWWWWWWWWWWWWWWWWWWWWWW           ",
			"         WWWWWWWWWWWWWWWWWWWWWWWWWWWWW          ",
			"        WWWWWWWWWWWWWWWWWWWWWWWWWWWWWWW         ",
			"       YYYYYYYYYYYYYYYYYYYYYYYYYYYYYYYYY        ",
			"      YYYYYYYYYYYYYYYYYYYYYYYYYYYYYYYYYYY       ",
			"                  YYYYYYYYYYYYYYYYYYYYYYYY      ",
			"                              YYYYYYYYYYYY      ",
			"                                                ",
			"                                                ",
			"                                                ",
			"                                                ",
			"                                                ",
			"                                                ",
			"                                                ",
			"                                                ",
			"                                                ",
			"                                                ",
			"                                                ",
			"                                                ",
			"                                                ",
			"                                                ",
			"                                                ",
			"                                                ",
			"                                                ",
			"                                                ",
			"                                                ",
			"                                                ",
			"                                                ",
			"                                                ",
			"                                                ",
			"                                                "
		],
      "palettes": [ "roof_palette" ],
    "terrain": {
        "D": "t_concrete",
        "X": "t_concrete",
        "Y": "t_concrete",
        "W": "t_concrete",
        "Z": "t_concrete"
    },
	"//": "Whatever the bottom line is, it should have the RAMP_DOWN flag"
    }
  }
]
